XXXXXXXXXXXXXXXXXXXXXXXX
X0000000000000000000000X
X00WW00000000000000WW00X
X00WW00000000000000WW00X
X0000000000000000000000X
X000000000WWWW000000000X
X000000000WWWW000000000X
D000000000WWWW000E00000T
X000000000WWWW000000000X
X000000000WWWW000000000X
X0000000000000000000000X
X00WW00000000000000WW00X
X00WW00000000000000WW00X
X0000000000000000000000X
XXXXXXXXXXXXXXXXXXXXXXXX
