XXXXXXXXXXXXXXXXXXXXXXXX
X0000000000000000000000X
X0000000000000000000000X
X0000000000000000000000X
X0000000000000000000000X
X0000000000000000000000X
X0000000000000000000000X
X0000000000000000000000D
X0000000000000000000000X
X0000000000000000000000X
X0000000000000000000000X
X0000000000000000000000X
X0000000000000000000000X
X0000000000000000000000X
XXXXXXXXXXXXXXXXXXXXXXXX
