XXXXXXXXXXXXXXXXXXXXXXXX
X0000000000000000000000X
X0000000000000000000000X
X0000WWWWWWWWWWWWW00000X
X0000WWWWWWWWWWWWW00000X
X000000000000000WW00000X
X000000000000000WW00000X
D000000000000I00WW00000D
X000000000000000WW00000X
X000000000000000WW00000X
X0000WWWWWWWWWWWWW00000X
X0000WWWWWWWWWWWWW00000X
X0000000000000000000000X
X0000000000000000000000X
XXXXXXXXXXXXXXXXXXXXXXXX
