XXXXXXXXXXXDXXXXXXXXXXXX
XWWWWWWWW     WWWWWWWWWX
XWWWWWWWW     WWWWWWWWWX
XWWWWWWWW     WWWWWWWWWX
XWWW       I        WWWX
X                      X
X    WWWWWFFFWWWWW     X
D   WWWWWWFEFWWWWWW    D
X    WWWWWFFFWWWWW     X
X                      X
XWWW       I        WWwX
XWWWWWWWW     WWWWWWWWWX
XWWWWWWWW     WWWWWWWWWX
XWWWWWWWW     WWWWWWWWWX
XXXXXXXXXXXDXXXXXXXXXXXX
