XXXXXXXXXXXXXXXXXXXX 
X000000000000000000X
X000000000000000000X
X000000MMMMMM000000X
X00000000000M000000X
X00000000000M000000X
X00000000000M000000X
X0000F000000M000000d
X00000000000M000000X
X00000000000M000000X
X00000000000M000000X
X000000MMMMMM000000X
X000000000000000000X
X000000000000000000X
XXXXXXXXXXXXXXXXXXXX

XXXXXXXXXXXXXXXXXXXX 
X000000000000000000X
X000000000000000000X
X000MMMMMMMMMMMMM00X
X000OOOOOOOOOOOOO00X
X000MMMMMMMMMMMMM00X
X000000000000000000X
d000000000000000000d
X000000000000000000X
X000MMMMMMMMMMMM000X
X000000000000000000X
X000MMMMMMMMMMMM000X
X000000000000000000X
X000000000000000000X
XXXXXXXXXXXXXXXXXXXX

XXXXXXXXXXXXXXXXXXXX 
X000000000000000000X
X000000000000000000X
X000000000000000000X
X000000000000000000X
X000000000000000000X
X000000000000000000X
d000000000T00000000X
X000000000000000000X
X000000000000000000X
X000000000000000000X
X000000000000000000X
X000000000000000000X
X000000000000000000X
XXXXXXXXXXXXXXXXXXXX
